25 20
#############
#...........#    ########
#...s...s...######......#
#.......................#
#...........######......#
#.....s.....#    #......#
#...........######......#
#...........#.K..#......#
#####..######....###..###
    #..#...........#..#
    #..............#..#
    #..#...........#..#
  ###..####..W...###..###
  #..@....########......#
  #.......#      #......#
  #.......#      #......#
  #.......#      #......#
  #.......#      #......#
  #.......#      #......#
  #########       ######

